groupID	ISO3	climada worldmap country names	Region
	AFG	Afghanistan	Asia
	ALB	Albania	Europe
	DZA	Algeria	Africa
	ASM	American Samoa	Australia
	AND	Andorra	Europe
	AGO	Angola	Africa
7	AIA	Anguilla	North America
	ATG	Antigua and Barbuda	North America
	ARG	Argentina	South America
	ARM	Armenia	Asia
	ABW	Aruba	North America
8	AUS	Australia	Australia
	AUT	Austria	Europe
	AZE	Azerbaijan	Asia
	BHS	Bahamas	North America
	BHR	Bahrain	Asia
	BGD	Bangladesh	Asia
	BRB	Barbados	North America
	BLR	Belarus	Asia
	BEL	Belgium	Europe
	BLZ	Belize	North America
	BEN	Benin	Africa
	BMU	Bermuda	North America
	BTN	Bhutan	Asia
	BOL	Bolivia	South America
	BIH	Bosnia and Herzegovina	Europe
	BWA	Botswana	Africa
	BVT	Bouvet Island	Antarctica
	BRA	Brazil	South America
7	IOT	British Indian Ocean Territory	Europe
7	VGB	Virgin Islands (British)	North America
	BRN	Brunei	Asia
	BGR	Bulgaria	Europe
	BFA	Burkina Faso	Africa
	MMR	Myanmar (Burma)	Asia
	BDI	Burundi	Africa
	KHM	Cambodia	Asia
	CMR	Cameroon	Africa
	CAN	Canada	North America
	CPV	Cape Verde	Africa
	CYM	Cayman Islands	North America
	CAF	Central African Republic	Africa
	TCD	Chad	Africa
	CHL	Chile	South America
2	CHN	China	Asia
8	CXR	Christmas Island	Australia
8	CCK	Cocos (Keeling) Islands	Australia
	COL	Colombia	South America
	COM	Comoros	Africa
	COG	Congo	Africa
9	COK	Cook Islands	Australia
	CRI	Costa Rica	North America
	CIV	Ivory Coast	Africa
	HRV	Croatia	Europe
	CUB	Cuba	North America
	CYP	Cyprus	Europe
	CZE	Czech Republic	Europe
	DNK	Denmark	Europe
	DJI	Djibouti	Africa
	DMA	Dominica	North America
	DOM	Dominican Republic	North America
	ECU	Ecuador	South America
	EGY	Egypt	Africa
	SLV	El Salvador	North America
	GNQ	Equatorial Guinea	Australia
	ERI	Eritrea	Africa
	EST	Estonia	Europe
	ETH	Ethiopia	Africa
6	REU	Europa Islands	Europe
7	FLK	Falkland Islands (Malvinas)	Europe
	FRO	Faroe Islands	Europe
	FSM	Micronesia (Federated States of)	Australia
	FJI	Fiji	Australia
	FIN	Finland	Europe
6	FRA	France	Europe
6	GUF	French Guyana	South America
	PYF	French Polynesia	Australia
6	ATF	French Southern Territories	Australia
	GAB	Gabon	Africa
	GMB	Gambia	Africa
12	-	Gaza Strip	Asia
	GEO	Georgia	Asia
	DEU	Germany	Europe
	GHA	Ghana	Africa
	GRC	Greece	Europe
	GRL	Greenland	Europe
	GRD	Grenada	Europe
	GLP	Guadeloupe	North America
	GUM	Guam	Asia
	GTM	Guatemala	North America
	GIN	Guinea	Australia
	GNB	Guinea-Bissau	Australia
	GUY	Guyana	South America
	HTI	Haiti	North America
8	HMD	Heard Island and Mcdonald Islands	Antarctica
	HND	Honduras	North America
	HUN	Hungary	Europe
	ISL	Iceland	Europe
4	IND	India	Asia
	IDN	Indonesia	Asia
	IRN	Iran- Islamic Republic of	Asia
	IRQ	Iraq	Asia
	IRL	Ireland	Europe
12	ISR	Israel	Asia
	ITA	Italy	Europe
	JAM	Jamaica	North America
11	SJM	Jan Mayen	Europe
	JPN	Japan	Asia
10	UMI	Jarvis	North America
	JOR	Jordan	Asia
	KAZ	Kazakhstan	Asia
	KEN	Kenya	Africa
	KIR	Kiribati	Australia
	PRK	North Korea	Asia
	KOR	South Korea	Asia
	KWT	Kuwait	Asia
	KGZ	Kyrgyzstan	Asia
	LAO	Lao People's Democratic Republic	Asia
	LVA	Latvia	Europe
	LBN	Lebanon	Asia
	LSO	Lesotho	Africa
	LBR	Liberia	Africa
	LBY	Libyan Arab Jamahiriya	Africa
	LIE	Liechtenstein	Europe
	LTU	Lithuania	Europe
	LUX	Luxembourg	Europe
	MKD	Macedonia - the former Yugoslav Republic of	Europe
	MDG	Madagascar	Africa
	MWI	Malawi	Africa
	MYS	Malaysia	Asia
	MLI	Mali	Africa
	MLT	Malta	Europe
	MHL	Marshall Islands	Europe
6	MTQ	Martinique	Europe
	MRT	Mauritania	Africa
	MUS	Mauritius	Australia
	MYT	Mayotte	Africa
	MEX	Mexico	North America
	MDA	Moldova - Republic of	Asia
	MNG	Mongolia	Asia
7	MSR	Montserrat	Europe
3	MAR	Morocco	Africa
	MOZ	Mozambique	Africa
	NAM	Namibia	Africa
	NRU	Nauru	Australia
	NPL	Nepal	Asia
	NLD	Netherlands	Europe
	ANT	Netherlands Antilles	North America
	NCL	New Caledonia	Australia
9	NZL	New Zealand	Australia
	NIC	Nicaragua	North America
	NER	Niger	Africa
	NGA	Nigeria	Africa
	NIU	Niue	Australia
12	-	Golan Heights	Asia
8	NFK	Norfolk Island	Europe
	MNP	Northern Mariana Islands	Asia
11	NOR	Norway	Europe
	OMN	Oman	Asia
	PAK	Pakistan	Asia
	PLW	Palau	Asia
10	UMI	Palmyra Atoll	Australia
	PAN	Panama	North America
	PNG	Papua New Guinea	Asia
	PRY	Paraguay	South America
	PER	Peru	South America
	PHL	Philippines	Asia
7	PCN	Pitcairn	Australia
	POL	Poland	Europe
	PRT	Portugal	Europe
	PRI	Puerto Rico	North America
	QAT	Qatar	Asia
6	REU	Reunion	Europe
	ROU	Romania	Europe
5	RUS	Russia	Asia
	RWA	Rwanda	Africa
	SMR	San Marino	Europe
	STP	Sao Tome and Principe	Africa
	SAU	Saudi Arabia	Asia
	SEN	Senegal	Africa
	SYC	Seychelles	Australia
	SLE	Sierra Leone	Africa
	SGP	Singapore	Asia
	SVK	Slovakia	Europe
	SVN	Slovenia	Europe
	SLB	Solomon Islands	Australia
	SOM	Somalia	Africa
	ZAF	South Africa	Africa
	ESP	Spain	Europe
	LKA	Sri Lanka	Asia
7	SHN	Saint Helena	Africa
	KNA	Saint Kitts and Nevis	North America
	LCA	Saint Lucia	North America
6	SPM	Saint Pierre and Miquelon	North America
	VCT	Saint Vincent and The Grenadines	North America
	SDN	Sudan	Africa
	SUR	Suriname	South America
11	SJM	Svalbard	Europe
	SWZ	Swaziland	Africa
	SWE	Sweden	Europe
	CHE	Switzerland	Europe
	SYR	Syrian Arab Republic	Asia
2	TWN	Taiwan	Asia
	TJK	Tajikistan	Asia
	TZA	Tanzania	Africa
	THA	Thailand	Asia
	TGO	Togo	Africa
	TON	Tonga	Australia
	TTO	Trinidad and Tobago	North America
	TUN	Tunisia	Africa
1	TUR	Turkey	Asia
	TKM	Turkmenistan	Asia
	TCA	Turks and Caicos Islands	North America
	TUV	Tuvalu	Australia
	UGA	Uganda	Africa
	UKR	Ukraine	Asia
	ARE	United Arab Emirates	Asia
7	GBR	United Kingdom	Europe
10	USA	United States (USA)	North America
	URY	Uruguay	South America
	UZB	Uzbekistan	Asia
	VUT	Vanuatu	Australia
	VEN	Venezuela	South America
	VNM	Viet Nam	Asia
	VIR	Virgin Islands (U.S.)	North America
10	UMI	Wake Island	North America
6	WLF	Wallis and Futuna Islands	Australia
	PSE	West Bank	Asia
3	ESH	Western Sahara	Africa
	WSM	Samoa	Australia
	YEM	Yemen	Africa
	COD	Congo (former Zaire)	Africa
	ZMB	Zambia	Africa
	ZWE	Zimbabwe	Africa
1	CYP	Cyprus Turkish part	Europe
	TLS	East Timor	Australia
7	SGS	South Georgia and South Sandwich Islands	Antarctica
5	-	Kuril Islands (administered by Russia. Claimed by Japan)	Asia
4	-	Kashmir and Jammu (claimed by India and Pakistan)	Asia
2	-	Aksai Chin (administered by China. Claimed by India)	Asia
	ATA	Antarctica	Antarctica
	SRB	Serbia	Europe
		Hong Kong	Asia
